#########################
#                       #
#   S                   #
#   A                   #
#   A                   #
#   AA                  #
#             A         #
#                       #
#########################                   
