%%%%%%%%%%%%%%%%%##%%%
%                    %
%                    %
%                    %
%                A   %
%                    %
%                M   %
%                    %
%                S   %
%                    %
%%%%%%%%%%%%%%%%%%%%%%
