%%%%%%%%%%%%%%%%%%%%%%
%          A         %
%                    %
%     S              %
%               A    %
%                    %
%                    %
%       A            %
%                S   %
% A          A       %
%%%%%%%%%%%%%%%%%%%%%%
