%%%%%%%%%%%%%%%%%%%%%%
%                    %
%                    %
%                A   %
%                A   %
%                A   %
%                A   %
%                A   %
%                S   %
%                    %
%%%%%%%%%%%%%%%%%%%%%%
