###########
#         #
# S     S #
#  AAA    #
#         #
#         #
###########
