###########
#         #
# S     S #
#  A      #
#     A   #
#         #
###########
